TTTGGGGGGGGGGGGGGGGGGGGGGGGGGTTT
TTTGGGGGGGGGGGGGGGGGGGGGGGGGGTTT
RRCRRRRRRRRRRRRRRCRRRRRRRRRRRRRR
RRRRRRFRRRRRRRFRRRRRRRRRRRRRRRRR
TTTGGGGGGGGGGGGGGGGGGGGGGGGGGTTT
RRRRRRRRRFRRRRRRRRRFRRRRRRRRFRRR
TTTGGGGGGGGGGGGGGGGGGGGGGGGGGTTT