TTTGGGGGGGGGGGGGGGGGGGGGGGGGGTTT
RRRRRRRRRFRRRRRRRRRFRRRRRRRRFRRR
RRRRRRFRRRRRRRFRRRRRRRRRRRRRRRRR
TTTGGGGGGGGGGGGGGGGGGGGGGGGGGTTT
RRRRRRFRRRRRRRFRRRRRRRRRRRRRRRRR
TTTGGGGGGGGGGGGGGGGGGGGGGGGGGTTT
TTTGGGGGGGGGGGGGGGGGGGGGGGGGGTTT
TTTGGGGGGGGGGGGGGGGGGGGGGGGGGTTT
RRCRRRRRRRCRRRRRRRRRRRRRRRRRRRRR
RRRRRRFRRRRRRRFRRRRRRRRRRRRRRRRR
TTTGGGGGGGGGGGGGGGGGGGGGGGGGGTTT
RRRRRRRRRFRRRRRRRRRFRRRRRRRRFRRR
TTTGGGGGGGGGGGGGGGGGGGGGGGGGGTTT
TTTGGGGGGGGGGGGGGGGGGGGGGGGGGTTT
TTTGGGGGGGGGGGGGGGGGGGGGGGGGGTTT
RRCRRRRRRRRRRRRRRCRRRRRRRRRRRRRR
RRRRRRFRRRRRRRFRRRRRRRRRRRRRRRRR
TTTGGGGGGGGGGGGGGGGGGGGGGGGGGTTT
TTTGGGGGGGGGGGGGGGGGGGGGGGGGGTTT
RRCRRRRRRRRRRRRRRCRRRRRRRRRRRRRR
TTTGGGGGGGGGGGGGGGGGGGGGGGGGGTTT
RRCRRRRRRRRRRRRRRCRRRRRRRRRRRRRR
RRRRRRFRRRRRRRFRRRRRRRRRRRRRRRRR
TTTGGGGGGGGGGGGGGGGGGGGGGGGGGTTT
RRRRRRRRRFRRRRRRRRRFRRRRRRRRFRRR
TTTGGGGGGGGGGGGGGGGGGGGGGGGGGTTT
TTTGGGGGGGGGGGGGGGGGGGGGGGGGGTTT
TTTGGGGGGGGGGGGGGGGGGGGGGGGGGTTT
RRCRRRRRRRRRRRRRRCRRRRRRRRRRRRRR
RRRRRRFRRRRRRRFRRRRRRRRRRRRRRRRR
TTTGGGGGGGGGGGGGGGGGGGGGGGGGGTTT
RRRRRRRRRFRRRRRRRRRFRRRRRRRRFRRR
TTTGGGGGGGGGGGGGGGGGGGGGGGGGGTTT